##Introduction
Getting Started=>getting-started

##Basic Features
Pages=>pages

##Data Fetching
Overview=>overview
getServerSideProps=>get-server-side-props
getStaticProps=>get-static-props
getStaticPaths=>get-static-paths
Incremental Static Regeneration=>incremental-static-regeneration
Client side=>client-side
Built-in CSS Support=>built-in-css-support
Layouts=>layouts
Image Optimization=>image-optimization
Font Optimization=>font-optimization
Static File Serving=>static-file-serving
Fast Refresh=>fast-refresh
ESLint=>eslint
TypeScript=>typescript
Environment Variables=>environment-variables
Supported Browsers and Features=>supported-browsers-features
Handling Scripts=>script

##Routing
Introduction=>introduction
Dynamic Routes=>dynamic-routes
Imperatively=>imperatively
Shallow Routing=>shallow-routing

##API Routes
Introduction=>introduction
Dynamic API Routes=>dynamic-api-routes
Request Helpers=>request-helpers
Response Helpers=>response-helpers
Edge API Routes=>edge-api-routes

##Advanced
Going to Production=>going-to-production
Deployment=>deployment
Authentication=>authentication
Testing=>testing
Accessibility=>accessibility

##Guides
Building Forms=>building-forms

##Advanced Features
Next.js Compiler=>compiler
Turbopack=>turbopack
Preview Mode=>preview-mode
Dynamic Import=>dynamic-import
Automatic Static Optimization=>automatic-static-optimization
Static HTML Export=>static-html-export
Absolute Imports and Module Path Aliases=>module-path-aliases
Using MDX=>using-mdx

##AMP Support
Introduction=>introduction
Adding AMP Components=>adding-amp-components
AMP Validation=>amp-validation
AMP in Static HTML export=>amp-in-static-html-export
TypeScript=>typescript
Customizing Babel Config=>customizing-babel-config
Customizing PostCSS Config=>customizing-postcss-config
Custom Server=>custom-server
Custom `App`=>custom-app
Custom `Document`=>custom-document
Custom Error Page=>custom-error-page
`src` Directory=>src-directory
CI Build Caching=>ci-build-caching
Multi Zones=>multi-zones
Measuring performance=>measuring-performance
Middleware=>middleware
Debugging=>debugging
Error Handling=>error-handling
Source Maps=>source-maps
Codemods=>codemods
Internationalized Routing=>i18n-routing
Output File Tracing=>output-file-tracing
Security Headers=>security-headers